5 5
1 1 1 100 1
1 1 100 100 1
1 1 1 1 1
1 100 1 1 1
100 100 1 1 1
0 0
4 4